R00000001 = 0004
R00000002 = 0084
R00000003 = 9500
R00000004 = xxxx
R00000005 = xxxx
R00000006 = 0033
R00000007 = 00xx
R00000008 = 0002
R00000009 = 007f
R0000000a = 0056
R0000000b = xxxx
R0000000c = 9500
R0000000d = 9560
R0000000e = 0080
R0000000f = xxxx
Time:       1201
Cycles:      120
PC:         0020
