R00000001 = aaaa
R00000002 = 0084
R00000003 = 9500
R00000004 = 9560
R00000005 = 007f
R00000006 = 0033
R00000007 = 007f
R00000008 = 007f
R00000009 = 007f
R0000000a = 0056
R0000000b = xxxx
R0000000c = 9500
R0000000d = 9560
R0000000e = 0080
R0000000f = xxxx
Time:       1211
Cycles:      121
PC:         0020
