R00000001 = 0001
R00000002 = 0002
R00000003 = 0001
R00000004 = 0002
R00000005 = 0001
R00000006 = 0002
R00000007 = 0001
R00000008 = 0002
R00000009 = 0001
R0000000a = 0002
R0000000b = 0050
R0000000c = 0150
R0000000d = xxxx
R0000000e = xxxx
R0000000f = xxxx
Time:       1061
Cycles:      106
PC:         001f
