R00000001 = 0001
R00000002 = 0002
R00000003 = 0001
R00000004 = 0002
R00000005 = xxxx
R00000006 = 0001
R00000007 = 03e8
R00000008 = 03e8
R00000009 = 0000
R0000000a = xxxx
R0000000b = 0020
R0000000c = 0120
R0000000d = xxxx
R0000000e = xxxx
R0000000f = xxxx
Time:      50491
Cycles:     5049
PC:         0011
